##############################################################################
##...................................#########....###############.....#####.##
##.#####.######.#############.######...........##.###....#..#####.#########.##
##.#####..###......####.......###################.#########.................##
##.######.###.####......#####.###################.#####H####.##.##########.###
##.##.###.###.#########.####.................................##.#########..###
##.##.###....................####.#####.################.######.#########.####
##.##.###.#######################.#####.#####.....######.######.##........####
##.##.###........######.................#########..................#.####.####
##.##.##########..#####.#########.#####..........###################.####.####
##.##.###########.#####.#########.#####.################...............##.####
##...........................####.#####.#.##.###.###.###.#######.###.#.##.####
#####.#######.#########.#########.#####.#.##.###.###.###.#######..........####
#####.#....##.#########.#########.......#................#######.########.####
###...#.##.##.....................#####.#.##.###.###.###.#######.########.####
###.#.#.###############################.#.##.###.###.###.#######.########.####
###.#.#.#############H#################.################...............#####.#
###.#....................................................#############.#####.#
###.#############.#############.#######.######.###########.###.###.###.##....#
###.###########.................#######.######.###.###.###.###.###.###.##.####
##..###########.#######################.....##.###.###.###.###.###.###.##.####
###.........................###########.###..#.###..........................##
###.#######################.............######.###.###.###.###.###.###.####.##
###.##.................##.########.##.#.....##.###.###.###.###.###.###.####.##
###.##########.##########.########.##.##.##.##.###.###.###.###.###.###.####.##
###................................##.##.##.##.#######################.####.##
###.##########.##########.########.##.##.#####..............##########.####.##
###.##########.##########.########.##.##.#####.####.#######.....#............#
###................................##.##.#####.####.#######.#####.####.#####.#
###.##########.##########.########.##.##.#####.####.........#####.####.#####.#
###.##########.##########.########.##.##.#####.#######.####.#####.####.#####.#
###................................##.##.#####...............................#
###.##########.##########.########.##.##.#####.###############################
###.##########.##########.########.##.##.#####.###############################
###...................................##.#####.###############################
###.##########.#########################.#####.###############################
###............#########################.#####.###############################
###################......................#####.###############################
###################.##########################.###############################
###################.##########################..##############################
###################.###########################.##############################
#########...........###########################.##############################
#########.##.###.##.##################.....................................###
#########.##.#......##############.....########.######.###.########.###.##.###
#########.##...####.##############.###..........######.###.####.....###.##.###
#########.##.##.....##############.###.#####.#########.###.####.##.####..#.###
#............######.##############.###.#####...............####.##.#####...###
#.###.#.##.#.....##.##############.###.###########.#######.........##....#.###
#.....#.##.#.###.##.##############.###.....................#####.####.####.###
#.###.................................#######.#########H########....#.####.###
#.###.##.##.####.##.#########################....###############.##.#.####.###
#.######.##......##.############################.###############.##.#.####.###
#....##.....####.##.############################...........................###
####.##.#####.......###############################.###########.####.#####.###
####....#####.##.##.#######......##################.....................##.###
####.##..........##.############...........#######.######.#####.#######.##.###
####.##.#####.##.##.############.#########.#######.######.#####............###
####................############.#########.#######.#####........##############
###..###.###.##.###........................#######....#######################
##############################################################################
