##############################################################################
#............####.....................................................####.###
##.##..#####.....###..######...###############.############.##..#####......###
#..###..####.########..#####.#..##############.......######.#..#######..##.###
##.####..###.#########..####.##..#############.############...#########..#.###
#..#####..##.............###.###..############.......######.#..#########...###
##.######..#.##########..##.##...############.############.##..#########..####
#..#######.................#.#..##############.......######.####..########.###
##.#########.#############.....###############.......######.#####..#######..##
#...........................................................................##
##.#####.#######...#####..##########.###################.####.###.####.##.####
#..#####..#####..#..####.#..########.####.........######.####.###.####.##..###
##.######..###..###..###.##....#####.####.########.#####.####.###.####.###.###
#..#######..#..#####..##.#..##..####.####.########.#####.####.###.####.###.###
##.########............#...####..###.####..........#####..........####.###.###
#..##########..#####..#.#.######..........########.#####.####.###.####.###.###
##..............###..##.#.#######..######.########.......####.###.####.###.###
##.####.###.###..#..###.#.######..##H###..########.#####.####.###.####.###.###
##.####.###.#####..####.#.#####..........#########........###.###..........###
#######.###.###########.#.##..###########..########..##.######...#####.##.####
#.........................................................................####
#...###.########..##..######.##..######..#.######..#.##.####..#.#..######.####
#.#..##.#######....##..#####.###..####..##.#####..##.##.###..##.##..#####.####
#.##..#.######..#...##..####.####..##..###.S###..###.##.##..###.###..####.####
#.###...#####..##.#..##..###.#####....####.###..####.##.##..###.####..###.####
#.#####.####..###.##..##.....######..#####.##..#####.##.#..####.#####..##.####
#.#####.###..#.##.###..#####.######..#####.#..######.##...#####.######..#..###
#.#####.##..##.##.####..####.######.######...#######.......................###
#.#####.#..###.##.#####..###...####.###....#########.######.########.#####.###
#.#####...####.##.######..##.#..........##.#########.######.########.#####.###
#............................######.######......................####.#####.###
#..#.#######...#############.######.######.#####.#####.###.####.####.#####.###
#..#..#####..#..############.######.######.#####.#####.###.####.####.#####.###
##.##..###..###..###########.######.######.#####.#####.###.####.####.#####.###
#............................#############.#####.#####.###.####.####.#####.###
#..#..######################.#############.#####.#####.###.####.####.#####.###
##.##..########............................................................###
##.###..####################.#############.####################.#####.###.####
##..............................................................#####.###..###
#........###################.#############.##########################.####..##
########..............................................................#####.##
#.###############....########......################........##########.#####.##
#.................##..........####..................##.###............#####.##
#.##########....######################################.##############.#####.##
#............##..................#####################.##############.#####.##
#.#############.####################................................#.####..##
#.##########.........................#################.############.#......###
############.############################.................#########.######.###
############.####.........................###############....##............###
##...........##...###########################.....##########....####.......###
#..############.#####.........................###.##################.#########
#.#############.#####.###########################.##################.#########
#...............#####.##..........###############.........................####
####.##########.#####.##.########.##.....#############.###########.######.####
###...................##.########.##.###...###########.###########.######..###
#...####################.########....#####..##########.###########.#######.###
#..........................................................................###
#.#############.###################.##########################.###########..##
#..#########.......###########..........##############...............##....###
##...........#####.............########.##############.#############.##.##.###
#.############.################.#######................#############.......###
#.#######...........###########..#######################..........############
#.#######.#########.######...............................########...........##
#.####....#########...##...################################################..#
#.####.##############....####..........#####.............######.............##
#.####.######################.########..###..###########..#####.##########..##
#.............................#########.....#############.......####.........#
#......########################......########################........####.##.#
#...######.........#####........####..........................###########.##.#
#.#..####..#######.####..####################################.............##.#
#..#...#..########......#####################....................###########.#
##..##...#################....................#####################..........#
###...############.........######################...................########.#
##..#..##..........#############..................####################.......#
##.###....#######################.###################..................#######
##....................................................################..######
#..########..####################.######################........#######..#####
##..#######..............................................######...........####
##############################################################################
